BBBBBBBBBBBBBBBBBBBBBBBBBBBBBBBB
JTTTTTTTTTTTTTTTTTTTTTTTTTTTTTTK
LFFFFFFFFFFFFFFFFFFFFFFFFFFFFFFR
LFFFFFFFFFFFFFFFFFFFFFFFFFFFFFFR
LFFFFODPFFFFFFFFFFFFFFFFFODPFFFR
LFFFFRBLFFFFFFFFFFFFFFFFFRBLFFFR
LFFFFMTNFFFFFFFFFFFFFFFFFMTNFFFR
LFFFFFFFFFFFFFFFFFFFFFFFFFFFFFFR
LFFFFFFFFFFFSSSSSSSFFFFFFFFFFFFR
LFFFFFFFFFFFFFFFFFFFFFFFFFFFFFFR
LFFFFFFFFFFFFFFFFFFFFFFFFFFFFFFR
LFFFFODDDDDDDDDDDDDDDDDDDDPFFFFR
LFFFFMTTTTTTTTTTTTTTTTTTTTNFFFFR
LFFFFFFFFFFFFFFFFFFFFFFFFFFFFFFR
LFFFFFFFFFFFFFFFFFFFFFFFFFFFFFFR
LFFFFFFFFFFFFFFFFFFFFFFFFFFFFFFR
LFFFFFFFFFFFFFFFFFFFFFFFFFFFFFFR
LFFFFODPFFFFFFFFFFFFFFFFFODPFFFR
LFFFFRBLFFFFFFFFFFFFFFFFFRBLFFFR
LFFFFMTNFFFFFFFFFFFFFFFFFMTNFFFR
LFFFFFFFFFFFFFFFFFFFFFFFFFFFFFFR
LFFFFFFFFFFFFFFFFFFFFFFFFFFFFFFR
LFFFFFFFFFFFFFFFFFFFFFFFFFFFFFFR
HDDDDDDDDDDDDDDDDDDDDDDDDDDDDDDI